1000020000
0100010000
0002000000
0102001020
2000001004
0010000000
0010002000
0320100000
0010000100
0002200000