1000000000
0100010000
0002010000
0102001020
2000001004
0012222000
0013002000
0002100000
0010000100
0002200000