1000000000
0000022200
0002000000
0102002020
2000001004
2212000000
1010002000
1200100000
1210000100
3202200000